,------------,
| ^ ^ ^      |
| \ | /      |
|   | ASGARD |
|   |        |
'------------'