,------------,
|  /\ATLANTIS|
| /O \/      |
| \  /\      |
|  \/        |
'------------'