,------------,
|\\\\////    |
| \\\///     |
|   ||EARTH  |
| ~~~~~~     |
'------------'