,------------,
| *    *     |
|  *  *      |
|   **       |
|   WAKANDA  |
'------------'